5
5
#####
#r#g#
#####
#b#o#
#####